##########
#   #    #
# . # X  #
# ###  ###
# #O     #
# ###    #
#   ###  #
#        #
#        #
##########