##########
#O #     #
#  #  X  #
#        #
#   ######
#        #
###      #
#        #
#      . #
##########